40 40 40 40 40 40 40 40 40 40 40 40 40 40 40 40 40 40 40 40
40 96 91 91 91 91 91 91 91 91 91 91 91 91 91 91 91 95 40 40
40 89 73 74 74 74 74 74 74 74 74 74 74 74 74 74 75 88 40 40
40 89 76 04 04 04 04 04 04 04 04 04 04 04 04 04 77 88 04 04
40 89 76 04 04 04 04 04 04 04 04 04 04 04 04 04 77 88 04 04
40 89 76 04 04 04 04 04 04 04 04 04 04 04 04 04 77 88 04 04
40 89 76 04 04 04 04 04 04 04 04 04 04 04 04 04 77 88 04 04
40 89 76 04 04 04 04 04 04 04 04 04 04 04 04 04 77 88 04 04
40 89 76 04 04 04 04 04 04 04 04 04 04 04 04 04 77 88 04 04
40 89 76 04 04 04 04 04 0 04 04 04 79 79 83 00 77 88 04 04
40 89 76 04 04 04 04 04 22 22 22 22 22 22 76 04 77 88 04 04
40 89 76 04 04 04 40 40 74 74 72 73 74 74 81 04 77 88 40 40
40 89 76 04 04 04 04 04 04 04 77 76 04 04 04 04 77 88 04 04
40 89 76 04 04 04 04 04 04 04 77 76 04 04 04 04 77 88 04 04
40 89 76 04 04 04 04 04 04 04 77 76 04 04 04 04 77 88 04 04
40 89 76 04 04 04 04 04 04 04 77 76 04 04 04 04 77 88 40 40
40 89 76 04 04 04 04 04 04 04 77 76 04 04 04 04 77 88 04 04
40 89 71 66 66 66 66 66 66 66 70 71 66 66 66 66 70 88 40 04
54 94 86 86 86 86 86 86 86 86 86 86 86 86 86 86 86 93 40 54
40 40 40 40 40 40 40 40 40 40 40 40 40 40 40 40 40 40 40 04
